4 4 4 1 4 4 4 4 4 4 4 4 4 4 4 4 4 4 4 4 4 4 4 4 4 4 4 4 4 4 4 4 4 4 4 4 4 4 4 4 4 4 4 4 4 4 4 4 4 4 
4 2 1 1 2 6 6 6 6 6 6 6 6 6 6 6 6 6 6 6 6 6 6 6 6 6 6 6 6 6 6 6 6 6 6 6 6 6 6 6 6 6 6 6 6 6 6 6 6 4 
4 3 1 1 1 6 6 6 6 6 6 6 6 6 6 6 6 6 6 6 6 6 6 6 6 6 6 6 6 6 6 6 6 6 6 6 6 6 6 6 6 6 6 6 6 6 6 6 6 4 
4 1 1 2 1 1 3 1 3 1 1 1 1 1 1 1 1 2 1 1 1 2 1 1 1 1 1 1 2 1 1 1 8 8 8 8 8 8 8 8 8 8 8 8 8 8 8 6 6 4 
4 1 1 1 1 1 1 1 2 3 1 1 1 1 1 1 1 1 1 3 1 1 1 1 1 2 1 1 1 3 1 1 8 8 8 8 8 8 8 8 8 8 8 8 8 8 8 6 6 4 
4 6 6 6 6 1 6 6 1 1 1 1 1 1 1 1 6 6 6 6 6 6 6 6 6 6 6 6 6 6 6 6 7 6 6 6 6 6 6 6 6 6 6 6 6 8 8 6 6 4 
4 6 7 7 7 1 7 6 1 1 1 1 1 1 1 1 6 6 6 6 6 6 6 6 6 6 6 6 6 6 6 6 6 7 6 6 6 6 6 6 6 6 6 6 6 8 8 6 6 4 
4 6 7 16 9 1 7 6 1 1 2 1 1 1 1 1 1 1 1 1 1 1 1 1 2 1 1 1 1 1 1 1 1 1 1 1 1 1 1 1 1 1 1 6 6 8 8 6 6 4 
4 6 7 1 1 1 7 6 1 1 1 1 3 1 1 1 1 1 1 1 1 1 1 1 1 1 1 1 1 2 1 1 1 1 1 1 1 1 1 1 2 1 1 6 6 8 8 6 6 4 
4 6 7 1 1 1 7 6 1 3 1 1 1 1 2 1 1 1 1 1 1 1 1 1 1 1 1 1 3 1 3 1 1 1 1 1 1 1 2 1 1 1 1 6 6 6 8 6 6 4 
4 6 6 7 8 7 6 6 2 1 3 1 1 1 1 1 1 1 3 1 1 1 1 1 1 1 1 1 1 1 1 1 1 1 1 1 1 1 1 3 1 1 1 6 6 6 8 6 6 4 
4 6 6 6 8 6 6 1 1 1 1 1 1 1 1 1 1 1 1 1 1 1 1 1 1 1 1 1 1 1 1 1 1 1 1 1 1 1 1 1 1 1 1 6 6 6 8 6 6 4 
4 6 6 6 8 6 6 1 1 1 1 1 1 1 1 1 3 1 1 1 1 1 1 1 1 1 1 1 2 1 1 1 1 1 1 1 1 1 1 1 1 1 1 6 6 6 8 6 6 4 
4 6 6 6 8 6 6 1 1 1 1 2 1 1 1 1 1 1 1 1 1 1 1 1 1 1 1 1 1 1 1 1 1 1 1 1 1 1 2 1 1 1 1 6 6 6 8 6 6 4 
4 6 6 6 8 6 6 1 1 1 1 1 3 1 1 1 1 1 1 1 1 1 1 1 1 1 1 1 1 1 1 1 1 1 3 1 1 1 1 1 1 1 1 6 6 6 8 6 6 4 
4 6 6 6 8 6 6 1 1 1 3 1 1 1 1 1 1 1 1 1 1 1 1 1 1 1 1 3 1 1 1 1 1 1 1 1 1 1 1 1 1 1 1 6 6 6 8 6 6 4 
4 6 6 6 8 6 6 1 1 1 1 1 1 1 2 1 1 1 1 1 2 1 1 1 1 1 1 1 1 1 1 1 1 1 1 1 1 1 1 1 1 1 1 6 6 6 8 6 6 4 
4 6 6 6 8 6 6 1 1 1 1 1 1 1 1 1 1 1 1 1 1 1 1 1 1 1 1 1 1 1 1 1 1 1 1 3 1 1 1 1 1 1 1 6 6 6 8 6 6 4 
4 6 6 8 8 6 6 1 1 1 3 1 3 1 1 1 1 1 2 1 1 1 1 1 1 1 1 3 1 1 1 1 1 1 1 1 1 1 1 1 1 1 1 6 6 6 8 6 6 4 
4 6 6 8 8 6 6 1 1 1 1 1 1 1 1 1 1 1 1 1 17 1 1 1 1 1 1 1 1 1 1 1 1 2 3 1 1 1 1 1 1 1 1 6 6 6 8 6 6 4 
4 6 6 8 8 6 6 1 1 1 1 1 1 1 1 2 1 1 1 1 1 1 1 1 1 1 2 1 1 1 1 1 1 1 1 1 1 1 1 1 1 1 1 6 6 6 8 6 6 4 
4 6 6 8 8 6 6 1 1 1 1 1 1 1 1 2 1 1 1 1 1 1 1 1 1 1 1 1 1 1 1 1 1 1 1 1 1 1 1 1 1 1 1 6 6 6 1 6 6 4 
4 6 6 8 8 6 6 1 1 2 1 1 1 1 1 1 1 1 1 1 1 1 1 3 1 1 1 1 1 2 3 1 1 1 1 1 1 1 1 1 1 1 1 6 6 6 8 6 6 4 
4 6 6 1 1 6 6 1 1 1 1 1 1 1 1 1 1 1 1 1 1 1 1 1 1 1 1 1 1 1 1 1 1 1 1 1 1 1 2 1 1 1 1 6 6 6 2 7 1 4 
4 6 6 1 8 6 6 3 1 1 1 2 1 1 1 2 1 1 1 1 1 1 1 2 1 1 1 1 1 1 1 1 1 1 1 1 1 3 1 1 1 1 1 6 6 7 10 3 1 1 
4 6 6 8 8 6 6 1 1 1 1 1 1 1 1 1 1 1 1 1 1 1 2 1 1 1 1 1 1 1 1 1 1 1 1 1 1 1 1 1 1 1 1 6 6 7 7 7 6 4 
4 6 6 8 8 6 6 1 1 1 1 1 2 1 1 1 1 2 1 1 1 1 1 1 1 1 1 1 2 1 1 1 1 1 1 1 3 1 1 1 1 1 1 6 6 6 6 6 6 4 
4 6 6 1 8 6 6 1 1 1 1 2 1 1 1 1 1 1 1 1 1 1 1 1 1 1 1 1 1 1 1 1 1 1 1 1 1 1 1 1 1 1 1 1 1 1 1 6 6 4 
4 6 6 1 8 6 6 1 1 1 1 1 1 1 1 1 1 1 1 1 1 1 1 1 1 1 1 1 1 1 1 1 1 1 1 1 1 1 1 1 1 1 1 1 1 1 1 6 6 4 
4 6 6 8 1 6 6 1 1 1 1 1 1 1 1 1 1 1 2 1 1 1 1 1 1 1 1 1 3 1 1 1 1 1 1 1 1 3 1 1 1 1 1 2 1 1 1 6 6 4 
4 6 6 8 3 6 6 1 1 1 1 1 1 1 1 1 1 1 1 1 1 1 1 1 1 1 2 1 1 1 1 1 1 1 1 1 1 1 1 1 1 1 1 1 1 1 1 6 6 4 
4 6 6 1 2 6 6 3 1 1 1 1 1 1 1 3 1 1 1 1 1 1 1 1 1 1 1 1 1 1 1 1 1 1 1 2 1 1 1 1 1 3 1 1 1 1 1 6 6 4 
4 6 6 1 8 6 6 1 1 1 1 1 1 1 1 2 1 1 1 2 1 1 1 1 3 1 1 1 2 1 1 1 1 1 1 1 1 1 1 1 1 1 1 1 1 1 1 6 6 4 
4 6 6 1 8 6 6 1 1 1 1 1 1 1 1 1 1 1 1 1 1 1 1 1 1 1 1 1 1 1 1 1 1 1 1 1 1 1 1 1 1 1 1 1 1 1 1 6 6 4 
4 6 6 1 2 6 6 2 1 2 1 1 1 1 1 2 1 1 1 1 1 1 1 1 1 1 1 1 1 1 3 1 1 2 1 1 1 1 1 1 1 1 1 1 3 1 1 6 6 4 
4 6 6 2 1 6 6 1 1 1 1 1 1 1 1 1 1 1 1 1 1 1 1 1 1 1 1 1 1 1 1 1 1 1 1 1 1 1 1 1 1 1 1 2 1 1 1 6 6 4 
4 6 6 8 1 6 6 1 1 1 1 1 1 1 1 1 1 1 1 2 1 1 1 1 4 4 1 1 1 1 1 1 2 1 1 1 1 1 1 1 1 1 1 1 1 1 1 6 6 4 
4 6 6 1 2 6 6 1 2 1 1 3 1 1 1 1 1 1 1 1 1 1 1 1 4 4 1 1 1 1 1 1 1 1 1 1 3 1 1 1 1 1 1 1 1 1 1 6 6 4 
4 6 6 2 1 6 6 1 1 1 1 1 1 1 1 1 2 1 1 1 1 1 4 4 12 13 4 4 1 1 1 1 1 1 1 1 2 1 1 1 2 1 1 1 1 1 1 6 6 4 
4 6 6 1 2 6 6 1 1 1 2 1 1 3 1 1 1 1 1 1 1 1 4 4 14 15 4 4 1 1 1 1 1 1 1 3 1 1 1 1 1 1 1 2 1 1 1 1 6 4 
4 6 6 2 1 6 6 1 1 1 1 1 1 1 1 3 1 1 1 1 1 1 6 1 1 2 1 6 1 1 1 2 1 1 1 1 1 1 3 1 1 1 1 1 3 1 1 1 6 4 
4 6 6 8 1 6 6 1 1 1 1 1 1 1 1 1 1 1 1 1 1 1 6 1 1 2 1 6 1 1 1 1 1 3 1 1 1 1 2 1 1 1 1 1 1 1 1 1 6 4 
4 6 6 1 2 6 6 3 1 1 1 2 1 1 1 1 1 1 1 1 1 1 6 1 1 3 1 6 1 1 1 1 1 1 1 1 1 1 1 1 1 1 1 1 1 2 1 1 6 4 
4 6 6 1 8 6 6 6 6 6 6 6 8 8 8 6 6 6 6 6 6 6 6 1 1 1 1 6 6 6 6 6 6 6 6 6 6 6 6 6 6 6 6 6 6 6 2 3 6 4 
4 6 6 2 1 6 6 6 6 6 6 6 8 8 8 6 6 6 6 6 6 6 6 1 1 1 1 6 6 6 6 6 6 6 6 6 6 6 6 6 6 6 6 6 6 6 1 1 6 4 
4 6 6 1 2 8 1 1 8 1 8 1 2 1 1 1 1 3 1 1 1 1 1 1 2 1 1 1 3 1 1 1 1 1 1 1 1 2 3 1 1 1 1 16 6 6 1 1 6 4 
4 6 6 2 1 1 8 1 1 1 3 1 1 1 1 1 1 1 2 1 1 1 1 1 1 1 1 1 1 1 1 1 2 1 1 1 1 1 3 1 1 2 1 1 6 6 2 1 1 4 
4 6 6 6 6 6 6 6 6 6 6 6 6 6 6 6 6 6 6 6 6 6 6 6 6 6 6 6 6 6 6 6 6 6 6 6 6 6 6 6 6 6 6 1 6 6 1 1 1 4 
4 6 6 6 6 6 6 6 6 6 6 6 6 6 6 6 6 6 6 6 6 6 6 6 6 6 6 6 6 6 6 6 6 6 6 6 6 6 6 6 6 6 6 1 6 6 1 1 1 4 
4 4 4 4 4 4 4 4 4 4 4 4 4 4 4 4 4 4 4 4 4 4 4 4 4 4 4 4 4 4 4 4 4 4 4 4 4 4 4 4 4 4 4 1 4 4 4 4 4 4 
