0 0 0 0 0 0 0 0 0 0 0 0 0 0 0 0 0 0 0 0 0 0 0 0 0 0 0 0 0 0 0 0 0 0 0 0 0 0 0 0 0 0 0 0 0 0 0 0 0 0 
0 0 0 0 0 0 0 0 0 0 0 0 0 0 0 0 0 0 0 0 0 0 0 0 0 0 0 0 0 0 0 0 0 0 0 0 0 0 0 0 0 0 0 0 0 0 0 0 0 0 
0 0 0 0 0 0 0 0 0 0 0 0 0 0 0 0 0 0 0 0 0 0 0 0 0 0 0 0 0 0 0 0 0 0 0 0 0 0 0 0 0 0 0 0 0 0 0 0 0 0 
0 0 0 0 0 0 0 0 0 0 0 0 0 0 0 0 0 0 0 0 0 0 0 0 0 0 0 0 0 0 0 0 0 0 0 0 0 0 0 0 0 0 0 0 0 0 0 0 0 0 
0 0 0 0 0 0 0 0 0 0 0 0 0 0 0 0 0 0 0 0 0 0 0 0 0 0 0 0 0 0 0 0 0 0 0 0 0 0 0 0 0 0 0 0 0 0 0 0 0 0 
0 0 0 0 0 0 0 0 0 0 0 0 0 0 0 0 0 0 0 0 0 0 0 0 0 0 0 0 0 0 0 0 0 0 0 0 0 0 0 0 0 0 0 0 0 0 0 0 0 0 
0 0 0 0 0 0 0 4 4 4 4 4 4 4 4 4 4 4 4 4 4 4 4 4 4 4 4 4 4 4 4 4 4 4 4 4 4 4 4 4 4 4 4 0 0 0 0 0 0 0 
0 0 0 0 0 0 0 4 4 18 4 4 4 4 4 4 4 4 4 4 4 4 4 4 4 4 4 4 4 4 4 4 4 4 4 4 4 4 4 4 4 4 4 0 0 0 0 0 0 0 
0 0 0 0 0 0 0 4 18 18 4 4 4 4 22 19 19 19 19 19 19 23 4 4 4 4 4 4 4 4 4 18 18 18 18 18 18 4 4 4 4 4 4 0 0 0 0 0 0 0 
0 0 0 0 0 0 0 4 4 18 4 4 4 4 21 18 18 18 18 18 18 26 4 4 4 4 4 4 4 4 18 18 18 18 4 4 18 4 4 4 4 4 4 0 0 0 0 0 0 0 
0 0 0 0 0 0 0 4 4 18 18 18 18 18 18 18 18 18 18 18 18 26 4 4 4 4 18 18 18 18 18 18 18 4 4 4 18 18 4 4 4 4 4 0 0 0 0 0 0 0 
0 0 0 0 0 0 0 4 4 4 4 4 4 4 21 18 18 18 18 18 18 26 4 4 4 18 18 18 18 18 18 18 4 4 4 4 4 18 4 4 4 4 4 0 0 0 0 0 0 0 
0 0 0 0 0 0 0 4 4 4 4 4 4 4 24 20 20 20 18 20 20 25 4 4 18 18 18 18 18 18 4 4 4 4 4 4 4 18 18 4 4 4 4 0 0 0 0 0 0 0 
0 0 0 0 0 0 0 4 4 4 4 4 4 4 4 4 4 4 18 4 4 4 4 18 18 18 18 4 4 4 4 4 4 4 4 4 18 18 18 18 4 4 4 0 0 0 0 0 0 0 
0 0 0 0 0 0 0 4 4 4 4 4 4 4 4 4 4 4 18 4 4 4 18 18 18 4 4 4 4 4 4 4 4 4 4 18 18 18 18 18 4 4 4 0 0 0 0 0 0 0 
0 0 0 0 0 0 0 4 4 4 4 4 4 4 4 18 18 18 18 18 4 4 18 18 18 4 4 18 4 4 4 4 4 4 4 18 18 18 18 18 18 4 4 0 0 0 0 0 0 0 
0 0 0 0 0 0 0 4 4 4 4 4 4 18 18 18 4 18 18 18 4 4 18 4 4 4 4 18 4 4 4 4 4 4 18 18 18 18 18 18 18 4 4 0 0 0 0 0 0 0 
0 0 0 0 0 0 0 4 22 23 4 4 4 4 4 4 4 4 18 4 4 4 18 4 4 22 19 18 19 23 4 4 18 18 18 4 4 18 18 18 4 4 4 0 0 0 0 0 0 0 
0 0 0 0 0 0 0 4 21 18 19 19 23 4 4 4 4 4 18 4 4 4 18 4 4 21 18 18 18 26 4 18 18 4 4 4 4 4 18 4 4 4 4 0 0 0 0 0 0 0 
0 0 0 0 0 0 0 4 21 18 18 18 26 4 4 4 4 4 18 4 4 4 18 4 4 21 18 18 18 18 18 18 4 4 4 4 4 4 18 4 4 4 4 0 0 0 0 0 0 0 
0 0 0 0 0 0 0 4 21 18 18 18 26 4 4 4 4 4 18 4 4 4 18 4 4 24 20 20 20 25 4 4 4 4 4 4 4 4 18 4 4 4 4 0 0 0 0 0 0 0 
0 0 0 0 0 0 0 4 24 20 18 20 25 4 4 4 4 4 18 4 4 4 18 18 4 4 4 4 4 4 4 4 4 4 4 4 4 4 18 4 4 4 4 0 0 0 0 0 0 0 
0 0 0 0 0 0 0 4 4 4 18 4 4 4 4 4 4 4 18 4 54 18 18 18 4 4 4 4 4 4 4 4 4 4 4 4 4 4 18 4 4 4 4 0 0 0 0 0 0 0 
0 0 0 0 0 0 0 4 4 4 18 4 4 4 4 4 4 4 18 4 4 4 4 4 4 4 4 4 4 4 4 4 4 4 4 4 4 18 18 19 23 4 4 0 0 0 0 0 0 0 
0 0 0 0 0 0 0 4 4 4 18 4 4 22 19 19 19 19 18 19 19 19 23 4 4 4 4 4 4 4 4 4 4 4 18 18 18 18 18 18 26 4 4 0 0 0 0 0 0 0 
0 0 0 0 0 0 0 4 4 4 18 4 4 21 18 18 18 18 18 18 18 18 26 4 4 4 4 4 4 4 4 4 18 18 18 18 18 18 18 18 26 4 4 0 0 0 0 0 0 0 
0 0 0 0 0 0 0 4 4 4 18 18 18 18 18 18 18 18 18 18 18 18 26 4 4 4 4 4 4 4 4 4 18 18 18 18 18 18 18 18 26 4 4 0 0 0 0 0 0 0 
0 0 0 0 0 0 0 4 4 4 18 18 18 18 18 18 18 18 18 18 18 18 26 4 4 4 4 4 4 4 4 4 18 18 18 18 18 18 18 18 26 56 4 0 0 0 0 0 0 0 
0 0 0 0 0 0 0 4 4 4 4 4 4 24 20 20 20 18 18 20 20 20 20 20 20 20 18 18 18 18 18 18 18 18 18 18 18 4 4 21 26 4 4 0 0 0 0 0 0 0 
0 0 0 0 0 0 0 4 4 4 4 4 4 4 4 4 4 18 18 56 4 4 4 4 4 4 18 4 4 4 4 4 18 18 18 4 4 4 4 21 26 4 4 0 0 0 0 0 0 0 
0 0 0 0 0 0 0 4 4 4 4 4 4 4 4 4 4 18 18 4 4 4 4 4 4 4 18 4 4 4 4 4 4 4 4 4 4 4 4 21 26 4 4 0 0 0 0 0 0 0 
0 0 0 0 0 0 0 4 4 4 4 4 4 4 4 4 4 18 18 4 4 4 4 4 4 4 18 4 4 4 4 4 4 4 4 4 4 4 4 24 25 4 4 0 0 0 0 0 0 0 
0 0 0 0 0 0 0 4 4 4 4 4 4 4 4 4 4 18 18 4 4 4 4 4 4 4 18 4 4 56 56 56 56 56 56 56 56 56 56 56 56 56 56 0 0 0 0 0 0 0 
0 0 0 0 0 0 0 4 4 4 4 4 4 4 4 4 4 18 18 4 4 4 4 4 4 22 18 23 56 56 56 56 56 56 56 56 56 56 56 56 56 56 56 0 0 0 0 0 0 0 
0 0 0 0 0 0 0 4 4 4 4 4 4 4 4 4 4 18 18 4 4 4 4 4 4 24 20 25 56 56 56 56 56 56 56 56 56 56 56 56 56 56 56 0 0 0 0 0 0 0 
0 0 0 0 0 0 0 56 56 56 56 56 4 4 56 22 19 18 18 19 23 4 4 4 4 4 4 4 4 56 56 56 56 56 56 56 56 56 56 56 56 56 56 0 0 0 0 0 0 0 
0 0 0 0 0 0 0 56 56 56 56 56 56 56 56 21 18 18 18 18 26 4 4 4 4 4 4 4 4 56 56 56 56 56 56 56 56 56 56 56 56 56 56 0 0 0 0 0 0 0 
0 0 0 0 0 0 0 56 56 18 18 18 18 18 18 18 18 18 18 18 26 4 4 4 4 4 4 4 4 56 56 56 56 56 56 56 18 18 18 18 18 56 56 0 0 0 0 0 0 0 
0 0 0 0 0 0 0 56 56 18 56 56 56 56 56 21 18 18 18 18 26 4 4 4 4 4 4 4 4 4 4 4 18 18 18 18 18 18 56 56 18 56 56 0 0 0 0 0 0 0 
0 0 0 0 0 0 0 56 56 18 56 56 56 56 56 21 18 18 18 18 26 4 4 4 4 4 4 4 4 4 4 18 18 18 18 18 18 56 56 56 18 56 56 0 0 0 0 0 0 0 
0 0 0 0 0 0 0 56 22 18 23 56 56 56 56 24 20 20 20 20 20 20 20 20 20 20 20 20 20 20 20 20 18 18 18 18 18 56 56 56 18 56 56 0 0 0 0 0 0 0 
0 0 0 0 0 0 0 56 21 55 26 56 56 56 56 56 56 56 56 56 56 56 56 56 56 56 56 56 56 56 56 56 18 18 18 18 18 56 56 56 18 56 56 0 0 0 0 0 0 0 
0 0 0 0 0 0 0 56 24 20 25 56 56 56 56 56 56 56 56 56 56 56 56 56 56 56 56 56 56 56 56 56 56 56 56 56 56 56 56 56 56 56 56 0 0 0 0 0 0 0 
0 0 0 0 0 0 0 56 56 56 56 56 56 56 56 56 56 56 56 56 56 56 56 56 56 56 56 56 56 56 56 56 56 56 56 56 56 56 56 56 56 56 56 0 0 0 0 0 0 0 
0 0 0 0 0 0 0 0 0 0 0 0 0 0 0 0 0 0 0 0 0 0 0 0 0 0 0 0 0 0 0 0 0 0 0 0 0 0 0 0 0 0 0 0 0 0 0 0 0 0 
0 0 0 0 0 0 0 0 0 0 0 0 0 0 0 0 0 0 0 0 0 0 0 0 0 0 0 0 0 0 0 0 0 0 0 0 0 0 0 0 0 0 0 0 0 0 0 0 0 0 
0 0 0 0 0 0 0 0 0 0 0 0 0 0 0 0 0 0 0 0 0 0 0 0 0 0 0 0 0 0 0 0 0 0 0 0 0 0 0 0 0 0 0 0 0 0 0 0 0 0 
0 0 0 0 0 0 0 0 0 0 0 0 0 0 0 0 0 0 0 0 0 0 0 0 0 0 0 0 0 0 0 0 0 0 0 0 0 0 0 0 0 0 0 0 0 0 0 0 0 0 
0 0 0 0 0 0 0 0 0 0 0 0 0 0 0 0 0 0 0 0 0 0 0 0 0 0 0 0 0 0 0 0 0 0 0 0 0 0 0 0 0 0 0 0 0 0 0 0 0 0 
0 0 0 0 0 0 0 0 0 0 0 0 0 0 0 0 0 0 0 0 0 0 0 0 0 0 0 0 0 0 0 0 0 0 0 0 0 0 0 0 0 0 0 0 0 0 0 0 0 0 
